4 8 23 30
7 4 4 4
6 6 7 3
3 3 7 4
3 0 7 9
46 46 46 100 46 46 46 46 
46 88 126 61 46 126 88 79 
46 126 126 79 79 126 126 46 
46 61 46 46 46 46 61 46 
46 46 46 99 46 46 46 97 
46 126 126 46 46 126 126 46 
46 88 126 61 61 126 88 46 
46 46 46 46 79 46 98 46 
